Name	Package	Protection
com.google.android.apps.nexuslauncher.permission.READ_SETTINGS	com.google.android.apps.nexuslauncher	18
android.permission.LAUNCH_DEVICE_MANAGER_SETUP	android	67108866
com.google.android.settings.intelligence.apiproxy	com.google.android.settings.intelligence	2
com.google.android.gms.auth.api.phone.permission.SEND	com.google.android.gms	2
android.permission.REAL_GET_TASKS	android	18
android.permission.ACCESS_CACHE_FILESYSTEM	android	18
android.permission.REMOTE_AUDIO_PLAYBACK	android	2
android.permission.START_CROSS_PROFILE_ACTIVITIES	android	67108866
android.permission.DOWNLOAD_WITHOUT_NOTIFICATION	com.android.providers.downloads	
android.permission.NFC_PREFERRED_PAYMENT_INFO	android	
com.google.android.apps.dreamliner.permission.WRITE_DREAMLINER_INFO	com.google.android.apps.dreamliner	2
com.google.android.gms.permission.BIND_USER_STATUS_REPORT_SERVICE	com.google.android.gms	2
android.permission.WIFI_ACCESS_COEX_UNSAFE_CHANNELS	android	67108866
com.google.android.apps.photos.permission.C2D_MESSAGE	com.google.android.apps.photos	2
com.google.android.apps.nexuslauncher.permission.HOTSEAT_EDU	com.google.android.apps.nexuslauncher	18
android.permission.MANAGE_APPOPS	android	2
android.permission.REGISTER_WINDOW_MANAGER_LISTENERS	android	2
com.shannon.permission.IWLAN_CONFIGURATION	com.shannon.qualifiednetworksservice	2
android.permission.INTENT_FILTER_VERIFICATION_AGENT	android	18
com.google.android.wallpaper.effects.DYNAMIC_RECEIVER_NOT_EXPORTED_PERMISSION	com.google.android.wallpaper.effects	2
android.permission.BIND_INCALL_SERVICE	android	18
android.permission.PROVIDE_RESOLVER_RANKER_SERVICE	android	18
com.verizon.mips.services.feature_change_permission	com.verizon.mips.services	18
com.google.android.gms.trustagent.framework.model.DATA_CHANGE_NOTIFICATION	com.google.android.gms	2
android.permission.WRITE_SETTINGS	android	67110082
com.google.android.gm.permission.WRITE_GMAIL	com.google.android.gm	2
com.google.android.vending.verifier.ACCESS_VERIFIER	com.android.vending	2
com.google.android.apps.dreamliner.permission.DREAMLINER_SERVICE	com.google.android.apps.dreamliner	18
com.android.permission.INSTALL_EXISTING_PACKAGES	android	67108882
android.permission.MANAGE_TEST_NETWORKS	android	2
com.google.android.finsky.permission.BIND_GET_INSTALL_REFERRER_SERVICE	com.android.vending	
android.permission.READ_SMS	android	1
android.permission.CONTROL_KEYGUARD	android	2
android.permission.BIND_GAME_SERVICE	android	2
android.permission.MANAGE_CAMERA	android	2
android.permission.READ_WALLPAPER_INTERNAL	android	18
android.permission.MANAGE_CRATES	android	2
com.android.emergency.DYNAMIC_RECEIVER_NOT_EXPORTED_PERMISSION	com.android.emergency	2
android.permission.ACCESS_FPS_COUNTER	android	18
com.google.android.calendar.permission.C2D_MESSAGE	com.google.android.calendar	2
android.permission.CONFIGURE_WIFI_DISPLAY	android	2
android.permission.CONFIGURE_DISPLAY_COLOR_MODE	android	2
android.permission.SET_INPUT_CALIBRATION	android	2
com.google.android.gms.matchstick.permission.BROADCAST_LIGHTER_WEB_INFO	com.google.android.gms	2
android.permission.RECOVERY	android	18
android.permission.CONTROL_DISPLAY_COLOR_TRANSFORMS	android	18
android.permission.TEMPORARY_ENABLE_ACCESSIBILITY	android	2
com.android.systemui.DYNAMIC_RECEIVER_NOT_EXPORTED_PERMISSION	com.android.systemui	2
android.permission.SET_PROCESS_LIMIT	android	50
com.google.android.googleapps.permission.GOOGLE_AUTH.sitemaps	com.google.android.gsf	2
com.google.android.googlequicksearchbox.permission.C2D_MESSAGE	com.google.android.googlequicksearchbox	2
android.permission.READ_LOWPAN_CREDENTIAL	android	18
com.google.android.googleapps.permission.GOOGLE_AUTH.panoramio	com.google.android.gsf	
android.permission.FRAME_STATS	android	2
com.google.android.gm.permission.BROADCAST_INTERNAL	com.google.android.gm	2
com.google.android.gms.permission.APPINDEXING	com.google.android.gms	2
com.android.permission.ALLOWLIST_BLUETOOTH_DEVICE	com.google.android.bluetooth	18
com.android.keychain.DYNAMIC_RECEIVER_NOT_EXPORTED_PERMISSION	com.android.keychain	2
android.permission.GRANT_PROFILE_OWNER_DEVICE_IDS_ACCESS	android	2
com.shannon.rcsservice.permission.READ	com.shannon.rcsservice	18
android.permission.READ_CALENDAR	android	1
android.permission.POST_NOTIFICATIONS	android	4097
android.permission.BRICK	android	2
android.permission.LOCATION_BYPASS	android	18
android.permission.READ_CALL_LOG	android	1
android.permission.BIND_ATTENTION_SERVICE	android	2
com.google.android.c2dm.permission.RECEIVE	com.google.android.gsf	
android.permission.NFC_SET_CONTROLLER_ALWAYS_ON	android	18
android.permission.BIND_PRINT_RECOMMENDATION_SERVICE	android	2
com.shannon.qualifiednetworksservice.DYNAMIC_RECEIVER_NOT_EXPORTED_PERMISSION	com.shannon.qualifiednetworksservice	2
android.permission.ACCESS_ULTRASOUND	android	18
android.permission.TOGGLE_AUTOMOTIVE_PROJECTION	android	67108868
android.permission.ACCESS_FINE_LOCATION	android	4097
android.permission.RESTART_PACKAGES	android	
android.permission.STORAGE_INTERNAL	android	2
android.permission.USE_CREDENTIALS	android	
android.permission.TABLET_MODE	android	2
android.permission.NOTIFICATION_DURING_SETUP	android	18
android.permission.NETWORK_STATS_PROVIDER	android	2
android.permission.BIND_KEYGUARD_APPWIDGET	android	18
com.verizon.permission.STORE_DEMO_MODE	com.verizon.llkagent	18
android.permission.NETWORK_BYPASS_PRIVATE_DNS	android	2
com.google.android.googleapps.permission.GOOGLE_AUTH.sierrasandbox	com.google.android.gsf	2
android.permission.MANAGE_FACTORY_RESET_PROTECTION	android	18
android.permission.OVERRIDE_COMPAT_CHANGE_CONFIG_ON_RELEASE_BUILD	android	18
android.permission.READ_SYSTEM_UPDATE_INFO	android	18
android.permission.BIND_DEVICE_ADMIN	android	67108866
android.permission.MODIFY_AUDIO_SETTINGS	android	
android.permission.MANAGE_EXTERNAL_STORAGE	android	1090
com.android.apps.tag.DYNAMIC_RECEIVER_NOT_EXPORTED_PERMISSION	com.google.android.tag	2
android.permission.ACCESS_CHECKIN_PROPERTIES	android	18
android.permission.KILL_UID	android	258
android.permission.ENTER_CAR_MODE_PRIORITIZED	android	18
com.google.android.settings.future.logging.RESTRICTED_SEND_FUTURE_LOGS	com.android.settings	18
android.permission.SIGNAL_PERSISTENT_PROCESSES	android	50
android.permission.BIND_PRINT_SERVICE	android	2
android.permission.ACCESS_NOTIFICATION_POLICY	android	
com.android.permission.READ_OMADM_SETTINGS	com.android.omadm.service	18
android.permission.ACTIVITY_EMBEDDING	android	18
android.permission.BIND_RUNTIME_PERMISSION_PRESENTER_SERVICE	android	2
android.permission.CONTROL_ALWAYS_ON_VPN	android	2
com.google.SSRestartDetector.DYNAMIC_RECEIVER_NOT_EXPORTED_PERMISSION	com.google.SSRestartDetector	2
com.google.android.gms.dck.permission.DIGITAL_KEY_WRITE	com.google.android.gms	
android.permission.MODIFY_AUDIO_ROUTING	android	67108882
android.permission.RECEIVE_BLUETOOTH_MAP	android	18
android.permission.ACCESS_MOCK_LOCATION	android	2
android.permission.REQUEST_UNIQUE_ID_ATTESTATION	android	2
com.android.chrome.permission.TRANSLATE	com.android.chrome	2
android.permission.WIFI_UPDATE_COEX_UNSAFE_CHANNELS	android	67108866
android.permission.ACCESS_UCE_OPTIONS_SERVICE	android	18
android.permission.READ_ACTIVE_EMERGENCY_SESSION	android	2
android.permission.BIND_VR_LISTENER_SERVICE	android	2
com.google.android.apps.nbu.files.DYNAMIC_RECEIVER_NOT_EXPORTED_PERMISSION	com.google.android.apps.nbu.files	2
android.permission.GET_APP_OPS_STATS	android	50
android.permission.RECEIVE_DATA_ACTIVITY_CHANGE	android	18
android.permission.PROVISION_DEMO_DEVICE	android	2050
com.google.android.apps.maps.permission.ASSISTANT_GRPC_SYNC	com.google.android.apps.maps	
android.permission.READ_SAFETY_CENTER_STATUS	android	18
com.google.android.providers.gsf.permission.READ_GSERVICES	com.google.android.gsf	
android.permission.CONTROL_KEYGUARD_SECURE_NOTIFICATIONS	android	18
android.permission.ANSWER_PHONE_CALLS	android	8193
com.google.android.setupwizard.WRITE_DEVICE_ORIGIN	com.google.android.setupwizard	18
com.google.android.youtube.permission.C2D_MESSAGE	com.google.android.youtube	2
com.google.android.gms.permission.ACCESS_MULTIPACKAGE_COMPONENT	com.google.android.gms	2
android.permission.READ_WIFI_CREDENTIAL	android	18
com.google.android.gms.dck.permission.SE_APPLET_NOTIFICATION	com.google.android.gms	18
android.permission.BIND_DREAM_SERVICE	android	2
android.permission.REVOKE_POST_NOTIFICATIONS_WITHOUT_KILL	android	2
android.permission.ACCESS_TV_SHARED_FILTER	android	32786
android.permission.QUERY_AUDIO_STATE	android	67108866
android.permission.WRITE_GSERVICES	android	18
android.permission.MANAGE_ONE_TIME_PERMISSION_SESSIONS	android	258
com.android.printspooler.permission.ACCESS_ALL_PRINT_JOBS	com.android.printspooler	2
android.permission.READ_HOME_APP_SEARCH_DATA	android	67108868
android.permission.MANAGE_HOTWORD_DETECTION	android	1028
android.permission.INSTALL_LOCATION_PROVIDER	android	18
com.google.android.voicesearch.AUDIO_FILE_ACCESS	com.google.android.googlequicksearchbox	2
android.permission.USE_RESERVED_DISK	android	18
android.permission.MANAGE_LOW_POWER_STANDBY	android	18
android.ext.services.DYNAMIC_RECEIVER_NOT_EXPORTED_PERMISSION	com.google.android.ext.services	2
android.permission.START_ACTIVITY_AS_CALLER	android	2
android.permission.READ_RUNTIME_PROFILES	android	18
com.zhiliaoapp.musically.permission.wallpaper	com.zhiliaoapp.musically	2
android.permission.MANAGE_ACCOUNTS	android	
android.permission.CONTROL_WIFI_DISPLAY	android	2
com.android.vending.APP_ERRORS_SERVICE	com.google.android.gms	2
com.google.android.googleapps.permission.GOOGLE_AUTH.ah	com.google.android.gsf	2
com.google.android.googleapps.permission.GOOGLE_AUTH.cl	com.google.android.gsf	2
com.google.android.googleapps.permission.GOOGLE_AUTH.cp	com.google.android.gsf	2
com.google.android.googleapps.permission.GOOGLE_AUTH.ig	com.google.android.gsf	2
com.android.hotwordenrollment.okgoogle.DYNAMIC_RECEIVER_NOT_EXPORTED_PERMISSION	com.android.hotwordenrollment.okgoogle	2
com.zhiliaoapp.musically.permission.WRITE_ACCOUNT	com.zhiliaoapp.musically	2
androidx.appcompat.DYNAMIC_RECEIVER_NOT_EXPORTED_PERMISSION	com.google.android.carrierlocation	2
android.permission.SYSTEM_ALERT_WINDOW	android	2530
android.permission.MONITOR_DEFAULT_SMS_PACKAGE	android	18
android.permission.INSTANT_APP_FOREGROUND_SERVICE	android	4194
android.permission.BIND_CARRIER_SERVICES	android	18
com.google.android.googleapps.permission.GOOGLE_AUTH.lh2	com.google.android.gsf	2
com.google.android.gsf.subscribedfeeds.permission.C2D_MESSAGE	com.google.android.gsf	2
android.permission.BROADCAST_PHONE_ACCOUNT_REGISTRATION	com.android.server.telecom	18
android.permission.BIND_MUSIC_RECOGNITION_SERVICE	android	2
android.permission.START_TASKS_FROM_RECENTS	android	33554450
android.permission.NFC_TRANSACTION_EVENT	android	
com.google.android.providers.talk.permission.WRITE_ONLY	com.google.android.gsf	1
android.permission.CONTROL_LOCATION_UPDATES	android	18
android.permission.UPDATE_DOMAIN_VERIFICATION_USER_SELECTION	android	2
com.google.android.googleapps.permission.GOOGLE_AUTH.gbase	com.google.android.gsf	2
android.permission.ACCESS_SHARED_LIBRARIES	android	258
com.google.android.gms.permission.BIND_NETWORK_TASK_SERVICE	com.google.android.gms	2
android.permission.MANAGE_WIFI_INTERFACES	android	134217746
com.google.android.googleapps.permission.GOOGLE_AUTH.local	com.google.android.gsf	2
com.google.android.googleapps.permission.GOOGLE_AUTH.orkut	com.google.android.gsf	2
com.google.android.googleapps.permission.GOOGLE_AUTH.print	com.google.android.gsf	2
android.permission.RECEIVE_WAP_PUSH	android	1
android.permission.GET_TOP_ACTIVITY_INFO	android	33554434
com.android.hotspot2.osulogin.DYNAMIC_RECEIVER_NOT_EXPORTED_PERMISSION	com.google.android.hotspot2.osulogin	2
com.google.android.gms.auth.authzen.permission.DEVICE_SYNC_FINISHED	com.google.android.gms	2
com.google.android.googleapps.permission.GOOGLE_AUTH.OTHER_SERVICES	com.google.android.gsf	2
com.google.android.deskclock.DYNAMIC_RECEIVER_NOT_EXPORTED_PERMISSION	com.google.android.deskclock	2
android.permission.CLEAR_APP_USER_DATA	android	258
com.google.android.xmpp.permission.USE_XMPP_ENDPOINT	com.google.android.gsf	2
android.permission.UPGRADE_RUNTIME_PERMISSIONS	android	2
android.permission.START_REVIEW_PERMISSION_DECISIONS	android	258
android.permission.PROVIDE_TRUST_AGENT	android	18
android.permission.MONITOR_INPUT	android	33554434
android.permission.SET_VOLUME_KEY_LONG_PRESS_LISTENER	android	50
android.permission.BROADCAST_CALLLOG_INFO	com.android.server.telecom	18
com.google.android.gms.chromesync.permission.CONTENT_PROVIDER_ACCESS	com.google.android.gms	2
android.permission.TRIGGER_SHELL_PROFCOLLECT_UPLOAD	android	2
com.google.android.setupdesign.lottieloadinglayout.DYNAMIC_RECEIVER_NOT_EXPORTED_PERMISSION	com.google.android.carriersetup	2
android.permission.INSTALL_PACKAGES	android	18
android.permission.MANAGE_SOUND_TRIGGER	android	67108882
android.permission.SEND_RESPOND_VIA_MESSAGE	android	18
android.permission.CONTROL_UI_TRACING	android	50
com.google.android.columbus.permission.CONFIGURE_COLUMBUS_GESTURE	com.android.systemui	1026
com.google.android.ims.providers.ACCESS_DATA	com.google.android.ims	
android.permission.BIND_CALL_DIAGNOSTIC_SERVICE	android	2
android.permission.POWER_SAVER	android	18
com.google.android.googleapps.permission.GOOGLE_AUTH.doraemon	com.google.android.gsf	
android.permission.ACCESS_FM_RADIO	android	18
com.android.providers.media.DYNAMIC_RECEIVER_NOT_EXPORTED_PERMISSION	com.android.providers.media	2
android.permission.VIBRATE_ALWAYS_ON	android	2
android.permission.INSTALL_LOCATION_TIME_ZONE_PROVIDER_SERVICE	android	18
android.permission.MANAGE_VOICE_KEYPHRASES	android	18
android.permission.SHUTDOWN	android	67108882
android.permission.CHANGE_COMPONENT_ENABLED_STATE	android	67108882
com.google.android.gms.permission.CHECKIN_NOW	com.google.android.gms	2
android.permission.BIND_QUICK_SETTINGS_TILE	android	2
android.permission.BIND_TV_INPUT	android	18
android.permission.NFC	android	
android.permission.MANAGE_WIFI_NETWORK_SELECTION	android	134217746
android.permission.MODIFY_PARENTAL_CONTROLS	android	18
android.permission.INTERNAL_SYSTEM_WINDOW	android	2
android.permission.BIND_AMBIENT_CONTEXT_DETECTION_SERVICE	android	2
android.permission.PROCESS_PHONE_ACCOUNT_REGISTRATION	com.android.server.telecom	18
android.permission.INSTALL_DPC_PACKAGES	android	67108866
android.permission.BIND_TRANSLATION_SERVICE	android	2
android.permission.RETRIEVE_WINDOW_TOKEN	android	2
android.permission.BIND_ROTATION_RESOLVER_SERVICE	android	2
android.permission.MAKE_UID_VISIBLE	android	2
android.permission.REQUEST_COMPANION_START_FOREGROUND_SERVICES_FROM_BACKGROUND	android	
android.permission.BIND_AUTOFILL	android	2
com.google.android.gms.learning.permission.LAUNCH_IN_APP_PROXY	com.google.android.gms	2
android.permission.LOCK_DEVICE	android	18
android.permission.NETWORK_SETTINGS	android	2
android.permission.MANAGE_AUDIO_POLICY	android	2
com.google.android.googleapps.permission.GOOGLE_AUTH.writely	com.google.android.gsf	2
android.permission.NETWORK_SCAN	android	18
com.google.android.gms.permission.SEND_ANDROID_PAY_DATA	com.google.android.gms	2
com.google.android.apps.tycho.permission.INTERNAL_BROADCAST	com.google.android.apps.tycho	2
android.permission.MANAGE_WIFI_COUNTRY_CODE	android	2
android.permission.BODY_SENSORS	android	1
com.google.android.gm.permission.AUTO_SEND	com.google.android.gm	2
android.permission.CHANGE_OVERLAY_PACKAGES	android	18
android.permission.BIND_WALLPAPER	android	18
vendor.android.permission.BIND_OEMRILHOOK	com.samsung.slsi.telephony.oem.oemrilhookservice	18
android.permission.START_ANY_ACTIVITY	android	2
android.permission.SEND_DEVICE_CUSTOMIZATION_READY	android	18
android.permission.CAMERA_SEND_SYSTEM_EVENTS	android	18
android.permission.ACCESS_TUNED_INFO	android	32786
com.google.android.gms.permission.CAR_SPEED	com.google.android.gms	1
com.google.android.apps.now.OPT_IN_WIZARD	com.google.android.googlequicksearchbox	18
com.google.android.gms.auth.authzen.permission.GCM_DEVICE_PROXIMITY	com.google.android.gms	2
com.verizon.mips.services.install_status_permission	com.verizon.mips.services	18
com.google.android.apps.play.movies.common.permission.MOCK_FCM_RECEIVE	com.google.android.videos	2
android.permission.SEND_DOWNLOAD_COMPLETED_INTENTS	com.android.providers.downloads	2
android.permission.READ_GLOBAL_APP_SEARCH_DATA	android	67108868
com.google.android.googlequicksearchbox.permission.FINISH_GEL_ACTIVITY	com.google.android.googlequicksearchbox	2
androidx.core.DYNAMIC_RECEIVER_NOT_EXPORTED_PERMISSION	com.google.android.carrierlocation	2
com.android.shell.DYNAMIC_RECEIVER_NOT_EXPORTED_PERMISSION	com.android.shell	2
android.permission.GET_PROCESS_STATE_AND_OOM_SCORE	android	50
android.permission.BROADCAST_SMS	android	2
android.permission.CALL_PRIVILEGED	android	18
android.permission.BIND_INTENT_FILTER_VERIFIER	android	2
android.permission.BYPASS_ROLE_QUALIFICATION	android	67108868
android.permission.READ_PHONE_NUMBERS	android	4097
android.permission.MANAGE_APP_TOKENS	android	2
android.permission.CHANGE_NETWORK_STATE	android	
android.permission.CAPTURE_TV_INPUT	android	18
android.permission.MASTER_CLEAR	android	67108882
android.permission.FOREGROUND_SERVICE	android	4096
android.permission.PERSISTENT_ACTIVITY	android	
android.permission.BIND_TELECOM_CONNECTION_SERVICE	android	18
android.permission.WRITE_SYNC_SETTINGS	android	
com.google.android.providers.gsf.permission.WRITE_GSERVICES	com.google.android.gsf	2
com.google.android.apps.recorder.permission.RECORDER_ORIGIN	com.google.android.apps.recorder	2
android.permission.ALLOW_PLACE_IN_MULTI_PANE_SETTINGS	android	2
android.permission.MANAGE_DYNAMIC_SYSTEM	android	2
android.permission.CLEAR_FREEZE_PERIOD	android	2
com.google.android.wallpaper.effects.GENERATE_EFFECT	com.google.android.wallpaper.effects	1026
android.permission.SET_DEBUG_APP	android	50
android.permission.REQUEST_COMPANION_USE_DATA_IN_BACKGROUND	android	
com.zhiliaoapp.musically.permission.READ_ACCOUNT	com.zhiliaoapp.musically	2
com.android.systemui.permission.SEND_ALERT_BROADCASTS	com.android.systemui	1026
com.google.android.storagemanager.DYNAMIC_RECEIVER_NOT_EXPORTED_PERMISSION	com.google.android.storagemanager	2
android.permission.ACCESS_CONTENT_PROVIDERS_EXTERNALLY	android	2
android.permission.LAUNCH_MULTI_PANE_SETTINGS_DEEP_LINK	android	1026
android.permission.RESET_SHORTCUT_MANAGER_THROTTLING	android	2
com.google.android.googleapps.permission.GOOGLE_AUTH.notebook	com.google.android.gsf	2
android.permission.RESET_FINGERPRINT_LOCKOUT	android	2
android.permission.STATSCOMPANION	android	2
android.permission.INSTALL_TEST_ONLY_PACKAGE	android	2
android.permission.MANAGE_ACTIVITY_TASKS	android	33554434
android.permission.MONITOR_DEVICE_CONFIG_ACCESS	android	2
android.permission.RECEIVE_BOOT_COMPLETED	android	
com.android.phone.DYNAMIC_RECEIVER_NOT_EXPORTED_PERMISSION	com.android.phone	2
com.google.android.pixelnfc.DYNAMIC_RECEIVER_NOT_EXPORTED_PERMISSION	com.google.android.pixelnfc	2
com.android.stk.DYNAMIC_RECEIVER_NOT_EXPORTED_PERMISSION	com.android.stk	2
com.shannon.rcsservice.DYNAMIC_RECEIVER_NOT_EXPORTED_PERMISSION	com.shannon.rcsservice	2
com.google.android.googlequicksearchbox.permission.LENS_SERVICE	com.google.android.googlequicksearchbox	
android.permission.MANAGE_WEAK_ESCROW_TOKEN	android	18
com.google.android.googleapps.permission.GOOGLE_AUTH	com.google.android.gsf	2
android.permission.LOOP_RADIO	android	18
android.permission.GLOBAL_SEARCH_CONTROL	android	2
android.permission.REQUEST_COMPANION_PROFILE_APP_STREAMING	android	18
android.permission.SUBSCRIBED_FEEDS_READ	android	
com.google.android.gms.permission.NEARBY_START_DISCOVERER	com.google.android.gms	2
android.permission.LISTEN_ALWAYS_REPORTED_SIGNAL_STRENGTH	android	67108866
android.permission.MANAGE_CONTENT_CAPTURE	android	2
android.permission.KEEP_UNINSTALLED_PACKAGES	android	2
com.google.android.gms.auth.permission.POST_SIGN_IN_ACCOUNT	com.google.android.gms	2
android.permission.MANAGE_BIND_INSTANT_SERVICE	android	2
android.permission.MANAGE_ROLE_HOLDERS	android	258
android.permission.UPDATE_FONTS	android	18
android.permission.CONTROL_DEVICE_LIGHTS	android	18
com.google.android.googleapps.permission.GOOGLE_AUTH.ALL_SERVICES	com.google.android.gsf	2
android.permission.PEERS_MAC_ADDRESS	android	67110914
android.permission.DEVICE_POWER	android	67108866
android.permission.HIGH_SAMPLING_RATE_SENSORS	android	
android.permission.NEARBY_WIFI_DEVICES	android	1
com.google.android.providers.settings.permission.READ_GSETTINGS	com.google.android.gsf	2
android.permission.BIND_CALL_REDIRECTION_SERVICE	android	18
android.permission.MANAGE_GAME_ACTIVITY	android	18
android.permission.WHITELIST_AUTO_REVOKE_PERMISSIONS	android	258
android.permission.RECEIVE_MMS	android	1
android.permission.RECEIVE_SMS	android	1
com.google.android.gms.cloudsave.BIND_EVENT_BROADCAST	com.google.android.gms	18
com.android.vending.permission.C2D_MESSAGE	com.android.vending	2
android.permission.SET_TIME_ZONE	android	67108882
android.permission.BIND_TV_INTERACTIVE_APP	android	18
com.customermobile.preload.StartOnBoot.PERMISSION	com.customermobile.preload.vzw	2
android.permission.REMOVE_TASKS	android	100663298
android.permission.READ_PRINT_SERVICES	android	1026
com.google.android.ambientindication.permission.AMBIENT_INDICATION	com.android.systemui	18
android.permission.MANAGE_SUBSCRIPTION_PLANS	android	18
com.google.android.apps.nexuslauncher.DYNAMIC_RECEIVER_NOT_EXPORTED_PERMISSION	com.google.android.apps.nexuslauncher	2
android.permission.SMS_FINANCIAL_TRANSACTIONS	android	66
com.google.android.googlequicksearchbox.permission.PAUSE_HOTWORD	com.google.android.googlequicksearchbox	18
android.permission.EXPAND_STATUS_BAR	android	
com.google.android.setupwizard.READ_DEFERRED_SETUP_REASON	com.google.android.setupwizard	18
com.android.launcher.permission.UNINSTALL_SHORTCUT	android	
android.permission.ACCESS_RCS_USER_CAPABILITY_EXCHANGE	android	67108868
android.permission.MANAGE_PROFILE_AND_DEVICE_OWNERS	android	67108866
android.permission.BLUETOOTH_CONNECT	android	1
com.google.android.permission.USE_CBRS_MONITOR	com.google.android.apps.cbrsnetworkmonitor	18
android.permission.PACKAGE_ROLLBACK_AGENT	android	2
com.google.android.googlequicksearchbox.permission.LAUNCH_FROM_GMM	com.google.android.googlequicksearchbox	2
android.permission.USE_ICC_AUTH_WITH_DEVICE_IDENTIFIER	android	66
android.permission.BIND_TRACE_REPORT_SERVICE	android	2
com.google.android.gms.permission.REPORT_TAP	com.google.android.gms	2
android.permission.RESTART_WIFI_SUBSYSTEM	android	18
android.permission.REQUEST_IGNORE_BATTERY_OPTIMIZATIONS	android	
android.permission.READ_PROFILE	android	
android.permission.BIND_VOICE_INTERACTION	android	2
com.google.android.gtalkservice.permission.SEND_HEARTBEAT	com.google.android.gsf	18
com.qorvo.uwb.permission.SE_STATE_REQUEST	com.qorvo.uwb.vendorservice	2
android.permission.BLUETOOTH	android	
android.permission.BROADCAST_WAP_PUSH	android	2
android.permission.CHANGE_WIFI_MULTICAST_STATE	android	
com.vzw.services.lc.SWITCH_ENV	com.verizon.mips.services	2
com.google.android.onetimeinitializer.permission.ONE_TIME_INITIALIZED	com.google.android.onetimeinitializer	2
android.permission.DVB_DEVICE	android	18
com.google.android.messages.rcs.PROVISIONING_EVENT	com.google.android.apps.messaging	
android.permission.RESET_PASSWORD	android	18
android.permission.BIND_DOMAIN_VERIFICATION_AGENT	android	2
android.permission.PERFORM_SIM_ACTIVATION	android	18
android.permission.MANAGE_ROTATION_RESOLVER	android	2
com.android.alarm.permission.SET_ALARM	android	
android.permission.CAPTURE_AUDIO_HOTWORD	android	67108882
android.permission.WRITE_MEDIA_STORAGE	android	18
android.permission.SIGNAL_REBOOT_READINESS	android	18
android.permission.RECORD_BACKGROUND_AUDIO	android	67108868
android.permission.CONTROL_DISPLAY_SATURATION	android	18
com.android.voicemail.permission.READ_VOICEMAIL	android	67108882
android.permission.WRITE_BLOCKED_NUMBERS	android	2
android.permission.ACCESS_AMBIENT_LIGHT_STATS	android	50
android.permission.GRANT_RUNTIME_PERMISSIONS_TO_TELEPHONY_DEFAULTS	android	2
android.permission.SET_INITIAL_LOCK	android	2050
android.permission.SET_ANIMATION_SCALE	android	50
com.google.android.gms.permission.AD_ID_NOTIFICATION	com.google.android.gms	
com.android.vending.setup.PLAY_SETUP_SERVICE	com.android.vending	
android.permission.WATCH_APPOPS	android	18
android.permission.GET_TASKS	android	
android.permission.BIND_CACHE_QUOTA_SERVICE	android	2
android.permission.BROADCAST_NETWORK_PRIVILEGED	android	18
android.permission.ACCESS_SURFACE_FLINGER	android	2
android.permission.SUBSCRIBED_FEEDS_WRITE	android	
com.google.euiccpixel.permission.SECURE_ELEMENT	com.google.euiccpixel.permissions	18
android.permission.AUTHENTICATE_ACCOUNTS	android	
android.permission.INTERNET	android	4096
android.permission.BIND_RESOLVER_RANKER_SERVICE	android	2
com.android.soundpicker.DYNAMIC_RECEIVER_NOT_EXPORTED_PERMISSION	com.android.soundpicker	2
com.android.vending.CHECK_LICENSE	com.android.vending	4096
android.permission.TV_INPUT_HARDWARE	android	32786
com.android.vending.INTENT_VENDING_ONLY	com.google.android.gsf	2
com.google.android.googleapps.permission.GOOGLE_AUTH.knol	com.google.android.gsf	2
com.google.android.googleapps.permission.GOOGLE_AUTH.mail	com.google.android.gsf	2
com.google.android.googleapps.permission.GOOGLE_AUTH.news	com.google.android.gsf	2
com.google.android.googleapps.permission.GOOGLE_AUTH.talk	com.google.android.gsf	2
com.google.android.googleapps.permission.GOOGLE_AUTH.wifi	com.google.android.gsf	2
com.google.android.googleapps.permission.GOOGLE_AUTH.wise	com.google.android.gsf	2
android.permission.TRANSMIT_IR	android	
com.google.android.gms.permission.C2D_MESSAGE	com.google.android.gms	2
android.permission.RETRIEVE_WINDOW_CONTENT	android	18
android.permission.VIRTUAL_INPUT_DEVICE	android	2
com.google.firebase.auth.api.gms.permission.LAUNCH_FEDERATED_SIGN_IN	com.google.android.gms	2
com.android.permission.CONNMO_SETTINGS	com.android.sdm.plugins.connmo	18
com.google.android.flipendo.DYNAMIC_RECEIVER_NOT_EXPORTED_PERMISSION	com.google.android.flipendo	2
com.breel.wallpapers.notifications	com.android.systemui	
android.permission.REORDER_TASKS	android	
android.permission.ACCESS_BROADCAST_RADIO	android	18
com.android.browser.permission.READ_HISTORY_BOOKMARKS	android	
android.permission.GET_INTENT_SENDER_INTENT	android	2
com.google.android.gms.presencemanager.permission.PRESENCE_MANAGER_UPDATE_BROADCAST	com.google.android.gms	2
android.permission.CONTROL_OEM_PAID_NETWORK_PREFERENCE	android	2
com.google.android.gms.nearby.exposurenotification.EXPOSURE_CALLBACK	com.google.android.gms	2
com.android.chrome.permission.CHILD_SERVICE	com.android.chrome	2
android.permission.BIND_CARRIER_MESSAGING_CLIENT_SERVICE	android	2
com.google.android.gms.permission.PHENOTYPE_OVERRIDE_FLAGS	com.google.android.gms	2
com.android.vending.BILLING	com.android.vending	4096
com.google.android.apps.gcs.permission.BROADCAST_NETWORK_SCORES	com.google.android.apps.gcs	2
android.permission.MANAGE_TIME_AND_ZONE_DETECTION	android	18
com.android.vending.setup.PLAY_PROGRESS_BIND	com.android.vending	2
android.permission.UPDATE_PACKAGES_WITHOUT_USER_ACTION	android	
android.permission.REQUEST_OBSERVE_COMPANION_DEVICE_PRESENCE	android	
android.permission.REQUEST_COMPANION_RUN_IN_BACKGROUND	android	
android.permission.READ_NEARBY_STREAMING_POLICY	android	
android.permission.BLUETOOTH_ADMIN	android	
android.permission.CONTROL_VPN	android	18
android.permission.BIND_HOTWORD_DETECTION_SERVICE	android	2
android.permission.UPDATE_DEVICE_STATS	android	67108882
android.permission.BLUETOOTH_STACK	android	67108866
android.permission.BLUETOOTH_MAP	android	67108866
android.permission.READ_ASSISTANT_APP_SEARCH_DATA	android	67108868
android.permission.READ_PRECISE_PHONE_STATE	android	18
com.google.android.gms.auth.api.signin.permission.REVOCATION_NOTIFICATION	com.google.android.gms	2
com.google.android.gms.magictether.permission.CONNECTED_HOST_CHANGED	com.google.android.gms	2
android.permission.DEBUG_VIRTUAL_MACHINE	com.google.android.virtualmachine.res	2
android.permission.MANAGE_FINGERPRINT	android	18
com.google.android.googleapps.permission.GOOGLE_AUTH.YouTubeUser	com.google.android.gsf	2
com.google.android.partnersetup.permission.UPDATE_CLIENT_ID	com.google.android.partnersetup	18
com.google.android.gms.permission.CONTACTS_SYNC_DELEGATION	com.google.android.gms	2
android.permission.READ_PROJECTION_STATE	android	2
com.verizon.vzwcarrierpermission	com.verizon.mips.services	
android.permission.WRITE_EMBEDDED_SUBSCRIPTIONS	android	50
android.permission.RECOVER_KEYSTORE	android	18
com.google.pixel.livewallpaper.permission.RECEIVE_PLACE_PICKER_RESULT	com.google.pixel.livewallpaper	2
com.google.android.googleapps.permission.GOOGLE_AUTH.androidsecure	com.google.android.gsf	2
com.verizon.svcs.fdo.FA_SWITCH_ENV	com.verizon.mips.services	2
android.permission.WRITE_DEVICE_CONFIG	android	524802
com.google.android.setupwizard.SETUP_BTS	com.google.android.setupwizard	2
android.permission.NET_ADMIN	android	67108866
android.permission.ROTATE_SURFACE_FLINGER	android	33554434
com.google.android.carrier.permission.WRITE_VENDOR_CONFIG	com.google.android.carrier	2
android.permission.RESTRICTED_VR_ACCESS	android	1026
android.permission.SUBSCRIBE_TO_KEYGUARD_LOCKED_STATE	android	67108868
android.permission.CARRIER_FILTER_SMS	android	18
com.google.android.setupwizard.SETUP	com.google.android.setupwizard	2
com.google.android.permission.BROADCAST_DATA_MESSAGE	com.google.android.gsf	18
com.google.android.gms.WRITE_VERIFY_APPS_CONSENT	com.google.android.gms	18
android.permission.SEND_SAFETY_CENTER_UPDATE	android	20
android.permission.PERFORM_IMS_SINGLE_REGISTRATION	android	67108868
android.permission.PERFORM_CDMA_PROVISIONING	android	67108882
com.google.android.gms.trustagent.permission.TRUSTAGENT_STATE	com.google.android.gms	2
android.permission.BIND_CONNECTION_SERVICE	android	18
android.permission.READ_EXTERNAL_STORAGE	android	1
com.google.android.gm.permission.READ_CONTENT_PROVIDER	com.google.android.gm	1
android.permission.BIND_QUICK_ACCESS_WALLET_SERVICE	android	2
com.google.android.pixel.setupwizard.DYNAMIC_RECEIVER_NOT_EXPORTED_PERMISSION	com.google.android.pixel.setupwizard	2
com.verizon.mips.services.download_status_permission	com.verizon.mips.services	18
android.permission.REQUEST_COMPANION_SELF_MANAGED	android	18
android.permission.INSTALL_GRANT_RUNTIME_PERMISSIONS	android	770
android.permission.WRITE_SOCIAL_STREAM	android	
com.zhiliaoapp.musically.permission.ATTRIBUTION_INFO	com.zhiliaoapp.musically	2
android.permission.EXEMPT_FROM_AUDIO_RECORD_RESTRICTIONS	android	67108882
com.android.companiondevicemanager.DYNAMIC_RECEIVER_NOT_EXPORTED_PERMISSION	com.android.companiondevicemanager	2
android.permission.NETWORK_MANAGED_PROVISIONING	android	67108866
android.permission.ACCESS_INSTANT_APPS	android	67109634
android.permission.DISABLE_SYSTEM_SOUND_EFFECTS	android	18
android.permission.MANAGE_ACCESSIBILITY	android	33556482
android.permission.CONTROL_REMOTE_APP_TRANSITION_ANIMATIONS	android	18
android.permission.LAUNCH_TRUST_AGENT_SETTINGS	android	18
android.permission.REGISTER_CALL_PROVIDER	android	18
com.google.android.gms.dck.permission.DIGITAL_KEY_PRIVILEGED	com.google.android.gms	2
android.permission.GET_PACKAGE_SIZE	android	
android.permission.MANAGE_COMPANION_DEVICES	android	67108866
android.permission.MODIFY_THEME_OVERLAY	android	2
android.permission.CLEAR_APP_GRANTED_URI_PERMISSIONS	android	2
android.permission.RECEIVE_DEVICE_CUSTOMIZATION_READY	android	1026
com.google.android.c2dm.permission.SEND	com.google.android.gsf	18
android.permission.BIND_VPN_SERVICE	android	2
com.android.remoteprovisioner.DYNAMIC_RECEIVER_NOT_EXPORTED_PERMISSION	com.android.remoteprovisioner	2
android.permission.USE_EXACT_ALARM	android	
com.google.android.settings.intelligence.BATTERY_DATA	com.google.android.settings.intelligence	18
android.permission.MANAGE_SAFETY_CENTER	android	67109124
android.permission.APPROVE_INCIDENT_REPORTS	android	1048578
android.permission.TRUST_LISTENER	android	2
com.android.intentresolver.DYNAMIC_RECEIVER_NOT_EXPORTED_PERMISSION	com.android.intentresolver	2
android.permission.ACCOUNT_MANAGER	android	2
android.permission.ACCESS_CONTEXT_HUB	android	18
com.google.android.apps.wallpaper.DYNAMIC_RECEIVER_NOT_EXPORTED_PERMISSION	com.google.android.apps.wallpaper	2
android.permission.MODIFY_USER_PREFERRED_DISPLAY_MODE	android	2
android.permission.UWB_PRIVILEGED	android	18
android.permission.MANAGE_USB	android	18
com.google.android.partnersetup.permission.WRITE_APP_PROVIDER	com.google.android.partnersetup	18
android.permission.REVIEW_ACCESSIBILITY_SERVICES	android	2
android.permission.ACCESS_ALL_DOWNLOADS	com.android.providers.downloads	2
android.permission.ALLOCATE_AGGRESSIVE	android	18
android.permission.INTERACT_ACROSS_USERS_FULL	android	67109122
com.android.hotwordenrollment.xgoogle.DYNAMIC_RECEIVER_NOT_EXPORTED_PERMISSION	com.android.hotwordenrollment.xgoogle	2
android.permission.SET_GAME_SERVICE	android	2
com.google.android.onetimeinitializer.DYNAMIC_RECEIVER_NOT_EXPORTED_PERMISSION	com.google.android.onetimeinitializer	2
android.permission.CHANGE_ACCESSIBILITY_VOLUME	android	2
android.permission.BIND_APPWIDGET	android	18
com.google.android.gms.permission.PHENOTYPE_UPDATE_BROADCAST	com.google.android.gms	2
android.permission.STOP_APP_SWITCHES	android	33554450
com.google.android.apps.gsa.nga.engine.stash.BROADCAST	com.google.android.googlequicksearchbox	2
android.permission.RECEIVE_MEDIA_RESOURCE_USAGE	android	18
android.permission.SYSTEM_CAMERA	android	67108882
com.android.cellbroadcastreceiver.DYNAMIC_RECEIVER_NOT_EXPORTED_PERMISSION	com.android.cellbroadcastreceiver	2
android.permission.BATTERY_STATS	android	50
com.google.android.gms.permission.INTERNAL_BROADCAST	com.google.android.gms	2
android.permission.CAPTURE_VOICE_COMMUNICATION_OUTPUT	android	67108882
android.permission.GET_HISTORICAL_APP_OPS_STATS	android	67108868
android.permission.PACKAGE_USAGE_STATS	android	16777330
com.android.nearby.halfsheet.DYNAMIC_RECEIVER_NOT_EXPORTED_PERMISSION	com.google.android.nearby.halfsheet	2
android.permission.NETWORK_SIGNAL_STRENGTH_WAKEUP	android	18
android.permission.WRITE_PROFILE	android	
android.permission.MOUNT_UNMOUNT_FILESYSTEMS	android	18
android.permission.GET_ACCOUNTS_PRIVILEGED	android	18
android.permission.READ_PRINT_SERVICE_RECOMMENDATIONS	android	1026
android.permission.TETHER_PRIVILEGED	android	18
android.permission.WRITE_SECURE_SETTINGS	android	67109170
android.permission.WRITE_SETTINGS_HOMEPAGE_DATA	android	18
com.android.vending.TOS_ACKED	com.android.vending	18
android.permission.SERIAL_PORT	android	18
android.permission.BIND_NOTIFICATION_LISTENER_SERVICE	android	2
android.permission.BIND_SCREENING_SERVICE	android	18
android.permission.MANAGE_APP_PREDICTIONS	android	67108866
android.permission.KEYPHRASE_ENROLLMENT_APPLICATION	android	18
com.google.android.apps.gcs.WRITE_EXPERIMENTS	com.google.android.apps.gcs	2
android.permission.FORCE_PERSISTABLE_URI_PERMISSIONS	android	2
android.permission.UNLIMITED_SHORTCUTS_API_CALLS	android	67108866
android.permission.CAPTURE_AUDIO_OUTPUT	android	67108882
android.permission.BIND_MIDI_DEVICE_SERVICE	android	2
android.permission.MANAGE_DEBUGGING	android	18
com.google.android.finsky.permission.INSTANT_APP_STATE	com.android.vending	2
com.google.android.googleapps.permission.GOOGLE_AUTH.grandcentral	com.google.android.gsf	2
com.google.android.gms.auth.proximity.permission.SMS_CONNECT_SETUP_REQUESTED	com.google.android.gms	2
android.permission.ACCESS_COARSE_LOCATION	android	4097
android.permission.MOVE_PACKAGE	android	18
com.google.sensor.elmyra.permission.USE_RAW_SENSOR	com.android.systemui	1026
android.permission.SET_ACTIVITY_WATCHER	android	2
com.google.android.gms.supervision.DYNAMIC_RECEIVER_NOT_EXPORTED_PERMISSION	com.google.android.gms.supervision	2
android.permission.READ_BLOCKED_NUMBERS	android	2
android.permission.REQUEST_PASSWORD_COMPLEXITY	android	
android.permission.ACCESS_VIBRATOR_STATE	android	18
com.google.android.apps.wallpaper.NOTIFY_ROTATING_WALLPAPER_CHANGED	com.google.android.apps.wallpaper	2
com.verizon.mips.services.RECEIVE_SUW_CARRIER_SCREENS_UPDATE	com.verizon.mips.services	18
android.permission.STATUS_BAR_SERVICE	android	2
com.google.android.gms.apps.helprtc.INTERNAL_BROADCAST	com.google.android.apps.helprtc	2
android.permission.AMBIENT_WALLPAPER	android	1026
android.permission.READ_SEARCH_INDEXABLES	android	18
com.android.permission.WRITE_OMADM_SETTINGS	com.android.omadm.service	18
android.permission.BIND_TIME_ZONE_PROVIDER_SERVICE	android	2
android.permission.CONTROL_DEVICE_STATE	android	2
com.google.android.settings.setup.dock.RUN_DOCK_SETUP	com.android.settings	18
android.permission.SUGGEST_TELEPHONY_TIME_AND_ZONE	android	2
android.permission.GET_PEOPLE_TILE_PREVIEW	android	33554434
android.permission.READ_PHONE_STATE	android	1
android.permission.TUNER_RESOURCE_ACCESS	android	32786
android.permission.NFC_HANDOVER_STATUS	android	18
android.permission.HIDE_OVERLAY_WINDOWS	android	
android.permission.ACCESS_BLOBS_ACROSS_USERS	android	67108914
android.permission.SCORE_NETWORKS	android	18
android.permission.LOG_COMPAT_CHANGE	android	18
android.permission.USE_FULL_SCREEN_INTENT	android	
android.permission.PROVISION_MANAGED_DEVICE_SILENTLY	com.android.managedprovisioning	1026
android.permission.DIAGNOSTIC	android	2
android.permission.RADIO_SCAN_WITHOUT_LOCATION	android	8388610
com.google.android.googleapps.permission.GOOGLE_AUTH.jotspot	com.google.android.gsf	2
android.permission.CALL_COMPANION_APP	android	
android.permission.ACCESS_LOCATION_EXTRA_COMMANDS	android	
android.permission.RECEIVE_WIFI_CREDENTIAL_CHANGE	android	18
android.permission.ACCESS_LOCUS_ID_USAGE_STATS	android	67108866
android.permission.BIND_DISPLAY_HASHING_SERVICE	android	2
android.permission.READ_PRIVILEGED_PHONE_STATE	android	67108882
com.google.android.gms.permission.GOOGLE_PAY	com.google.android.gms	2
android.permission.UPDATE_LOCK_TASK_PACKAGES	android	2050
android.permission.ACCESS_IMS_CALL_SERVICE	android	18
android.permission.TRIGGER_TIME_ZONE_RULES_CHECK	android	2
android.permission.SEND_SMS	android	1
android.permission.ACCESS_DOWNLOAD_MANAGER	com.android.providers.downloads	18
android.permission.BROADCAST_STICKY	android	
android.permission.ASSOCIATE_COMPANION_DEVICES	android	67108868
android.permission.INSTALL_PACKAGE_UPDATES	android	18
com.google.android.gms.chimera.permission.QUERY_MODULES	com.google.android.gms	2
android.permission.ASEC_ACCESS	android	2
android.permission.NETWORK_FACTORY	android	67108866
android.permission.BIND_REMOTE_DISPLAY	android	2
android.permission.BLUETOOTH_PRIVILEGED	android	18
com.google.android.apps.pixel.factoryota.permission.CONFIG_RESULT	com.google.android.factoryota	
android.permission.BATTERY_PREDICTION	android	18
android.permission.NETWORK_STACK	android	2
com.google.android.gms.permission.CAR	com.google.android.gms	2
android.permission.SET_ALWAYS_FINISH	android	50
com.android.systemui.plugin.globalactions.wallet.DYNAMIC_RECEIVER_NOT_EXPORTED_PERMISSION	com.android.systemui.plugin.globalactions.wallet	2
android.permission.CALL_PHONE	android	1
android.permission.REQUEST_INCIDENT_REPORT_APPROVAL	android	18
android.permission.HARDWARE_TEST	android	2
com.google.android.elmyra.permission.CONFIGURE_ASSIST_GESTURE	com.android.systemui	1026
android.permission.TEST_BIOMETRIC	android	2
android.permission.USE_BIOMETRIC_INTERNAL	android	2
android.permission.ASEC_CREATE	android	2
android.permission.OBSERVE_SENSOR_PRIVACY	android	67109124
android.permission.QUERY_TIME_ZONE_RULES	android	18
android.permission.PEEK_DROPBOX_DATA	android	2
android.permission.SET_SYSTEM_AUDIO_CAPTION	android	67108866
com.google.android.gms.smartdevice.permission.NOTIFY_QUICK_START_STATUS	com.google.android.gms	2
com.android.permission.USE_INSTALLER_V2	android	18
android.permission.WRITE_OBB	android	18
android.permission.WRITE_SMS	android	
android.permission.READ_MEDIA_IMAGES	android	1
com.google.pixel.livewallpaper.permission.DOWNLOAD_LIVE_WALLPAPER	com.google.pixel.livewallpaper	1026
com.google.android.gm.permission.READ_GMAIL	com.google.android.gm	2
android.permission.INSTALL_DYNAMIC_SYSTEM	android	18
android.permission.MANAGE_ETHERNET_NETWORKS	android	2
android.permission.CONTROL_DISPLAY_BRIGHTNESS	android	2
android.permission.SUBSTITUTE_NOTIFICATION_APP_NAME	android	18
com.google.android.xmpp.permission.BROADCAST	com.google.android.gsf	18
com.google.android.xmpp.permission.SEND_RECEIVE	com.google.android.gsf	2
android.intent.category.MASTER_CLEAR.permission.C2D_MESSAGE	android	2
android.permission.BIND_AUTOFILL_SERVICE	android	2
android.permission.WRITE_CONTACTS	android	1
android.permission.ACCESS_KEYGUARD_SECURE_STORAGE	android	2050
android.permission.BIND_JOB_SERVICE	android	2
android.permission.OBSERVE_ROLE_HOLDERS	android	258
android.permission.CONFIRM_FULL_BACKUP	android	2
android.permission.CAPTURE_SECURE_VIDEO_OUTPUT	android	2
com.google.android.googleapps.permission.GOOGLE_AUTH.goanna_mobile	com.google.android.gsf	
android.permission.SET_TIME	android	67108882
does.not.matter.DYNAMIC_RECEIVER_NOT_EXPORTED_PERMISSION	com.google.android.gsf	2
com.android.providers.media.permission.MANAGE_CLOUD_MEDIA_PROVIDERS	com.google.android.providers.media.module	2
android.permission.TIS_EXTENSION_INTERFACE	android	32786
android.permission.WRITE_APN_SETTINGS	android	18
com.google.android.xmpp.permission.XMPP_ENDPOINT_BROADCAST	com.google.android.gsf	18
com.google.android.providers.settings.permission.WRITE_GSETTINGS	com.google.android.gsf	2
android.permission.MANAGE_CLOUDSEARCH	android	67108882
android.permission.CHANGE_WIFI_STATE	android	
com.verizon.mips.services.COMPONENT_STATUS	com.verizon.mips.services	
android.permission.BIND_COMPANION_DEVICE_MANAGER_SERVICE	android	2
com.google.android.apps.restore.DYNAMIC_RECEIVER_NOT_EXPORTED_PERMISSION	com.google.android.apps.restore	2
com.android.permission.INJECT_OMADM_SETTINGS	com.android.omadm.service	18
com.google.android.apps.carrier.log.permission.SEND_LOGS	com.google.android.apps.carrier.log	18
android.permission.CAMERA_OPEN_CLOSE_LISTENER	android	2
com.google.android.googleapps.permission.GOOGLE_AUTH.adsense	com.google.android.gsf	2
android.permission.BIND_PACKAGE_VERIFIER	android	2
android.permission.READ_INSTALL_SESSIONS	android	
com.google.android.googleapps.permission.GOOGLE_AUTH.adwords	com.google.android.gsf	2
android.permission.MANAGE_IPSEC_TUNNELS	android	66
android.permission.MODIFY_CELL_BROADCASTS	android	18
android.permission.SYSTEM_APPLICATION_OVERLAY	android	100663554
android.permission.MODIFY_DAY_NIGHT_MODE	android	18
android.permission.BIND_ROUTE_PROVIDER	android	2
android.permission.RECEIVE_STK_COMMANDS	android	18
com.zhiliaoapp.musically.permission.RECEIVE_ADM_MESSAGE	com.zhiliaoapp.musically	2
android.permission.INPUT_CONSUMER	android	2
android.permission.GET_PASSWORD	android	2
android.permission.BIND_CARRIER_MESSAGING_SERVICE	android	18
android.permission.MANAGE_BIOMETRIC	android	2
android.permission.NETWORK_SETUP_WIZARD	android	2050
android.permission.ACCESS_BLUETOOTH_SHARE	com.google.android.bluetooth	18
android.permission.OBSERVE_APP_USAGE	android	18
android.permission.PACKAGE_VERIFICATION_AGENT	android	18
com.shannon.rcsservice.permission.WRITE	com.shannon.rcsservice	18
android.permission.SET_ORIENTATION	android	33554434
android.permission.REVOKE_RUNTIME_PERMISSIONS	android	770
android.permission.SET_DEFAULT_ACCOUNT_FOR_CONTACTS	android	67108868
android.permission.ACCESS_MESSAGES_ON_ICC	android	2
android.permission.MANAGE_MEDIA	android	1090
android.permission.BIND_EUICC_SERVICE	android	2
com.google.android.gms.permission.BIND_USER_STATUS_LISTENER_SERVICE	com.google.android.gms	2
android.permission.BIND_VISUAL_VOICEMAIL_SERVICE	android	18
android.permission.BODY_SENSORS_BACKGROUND	android	1
android.permission.MANAGE_USERS	android	18
com.android.vending.billing.BILLING_ACCOUNT_SERVICE	com.android.vending	18
com.google.android.gm.email.permission.ACCESS_PROVIDER	com.google.android.gm	2
com.google.android.gms.contextmanager.CONTEXT_MANAGER_RESTARTED_BROADCAST	com.google.android.gms	2
android.permission.SET_PREFERRED_APPLICATIONS	android	770
android.permission.BIND_TV_REMOTE_SERVICE	android	18
android.permission.FLASHLIGHT	android	
android.permission.RENOUNCE_PERMISSIONS	android	18
android.permission.SEND_CATEGORY_CAR_NOTIFICATIONS	android	18
android.permission.DELETE_CACHE_FILES	android	18
android.permission.SET_WALLPAPER_COMPONENT	android	18
android.permission.ACCESS_UCE_PRESENCE_SERVICE	android	18
android.permission.ACCESS_NETWORK_STATE	android	4096
android.permission.BIND_CONDITION_PROVIDER_SERVICE	android	2
android.permission.SET_DISPLAY_OFFSET	android	18
android.permission.BIND_COMPANION_DEVICE_SERVICE	android	2
android.permission.DOMAIN_VERIFICATION_AGENT	android	20
android.permission.ACCESS_MTP	android	18
android.permission.MODIFY_DEFAULT_AUDIO_EFFECTS	android	18
android.permission.DISABLE_KEYGUARD	android	
android.permission.OBSERVE_NETWORK_POLICY	android	2
android.permission.BACKUP	android	18
android.permission.MANAGE_BLUETOOTH_WHEN_WIRELESS_CONSENT_REQUIRED	android	2
android.permission.INTERNAL_DELETE_CACHE_FILES	android	2
android.permission.ACCEPT_HANDOVER	android	1
android.permission.PROCESS_CALLLOG_INFO	com.android.server.telecom	18
com.android.cellbroadcastreceiver.module.DYNAMIC_RECEIVER_NOT_EXPORTED_PERMISSION	com.google.android.cellbroadcastreceiver	2
com.google.android.googleapps.permission.GOOGLE_AUTH.youtube	com.google.android.gsf	2
com.google.android.gms.carsetup.DRIVING_MODE_MANAGER	com.google.android.gms	2
android.permission.CAMERA	android	4097
android.permission.CHANGE_CONFIGURATION	android	67108914
android.permission.USER_ACTIVITY	android	18
android.permission.LOCAL_MAC_ADDRESS	android	18
com.google.android.gms.permission.SHOW_PAYMENT_CARD_DETAILS	com.google.android.gms	2
com.google.android.gms.findmydevice.spot.permission.DEVICE_CHANGES	com.google.android.gms	2
com.google.android.projection.gearhead.DYNAMIC_RECEIVER_NOT_EXPORTED_PERMISSION	com.google.android.projection.gearhead	2
android.permission.READ_LOGS	android	50
android.permission.RESET_APP_ERRORS	android	2
com.google.android.apps.nbu.files.permission.C2D_MESSAGE	com.google.android.apps.nbu.files	2
com.android.permission.OMADM_CONFIGURE_DONE	com.android.omadm.service	2
android.permission.REQUEST_NOTIFICATION_ASSISTANT_SERVICE	android	67108882
android.permission.COPY_PROTECTED_DATA	android	2
com.google.android.gms.magictether.permission.SCANNED_DEVICE	com.google.android.gms	2
android.permission.MANAGE_SPEECH_RECOGNITION	android	2
com.google.android.setupwizard.PARTNER_SETUP	com.google.android.setupwizard	18
android.permission.MANAGE_ONGOING_CALLS	android	66
android.permission.BIND_AUTOFILL_FIELD_CLASSIFICATION_SERVICE	android	2
com.google.android.gms.auth.cryptauth.permission.CABLEV2_SERVER_LINK	com.google.android.gms	2
android.permission.ASEC_DESTROY	android	2
com.android.permission.USE_SYSTEM_DATA_LOADERS	android	2
android.permission.MANAGE_CONTENT_SUGGESTIONS	android	2
android.permission.INTERACT_ACROSS_USERS	android	67108914
android.permission.SET_WALLPAPER	android	
android.permission.ASEC_RENAME	android	2
com.google.android.gms.permission.ACTIVITY_RECOGNITION	com.google.android.gms	
android.permission.TRIGGER_SHELL_BUGREPORT	android	2
android.permission.MANAGE_CREDENTIAL_MANAGEMENT_APP	android	2
com.google.android.googleapps.permission.GOOGLE_AUTH.android	com.google.android.gsf	2
android.permission.SET_KEYBOARD_LAYOUT	android	2
com.google.android.googleapps.permission.GOOGLE_AUTH.finance	com.google.android.gsf	2
android.permission.BIND_CONTENT_SUGGESTIONS_SERVICE	android	2
android.permission.USE_DATA_IN_BACKGROUND	android	2
com.google.android.apps.wallpaper.CHANGE_DOCKED_CLOCK_FACE	com.google.android.apps.wallpaper	18
android.permission.WRITE_CALENDAR	android	1
android.permission.UPDATE_CONFIG	android	18
android.permission.ACCESS_NETWORK_CONDITIONS	android	18
android.permission.WRITE_CALL_LOG	android	1
android.permission.BROADCAST_CLOSE_SYSTEM_DIALOGS	android	33554450
android.permission.BIND_NOTIFICATION_ASSISTANT_SERVICE	android	2
com.google.android.setupwizard.SETUP_COMPAT_SERVICE	com.google.android.setupwizard	
android.permission.READ_DREAM_STATE	android	18
android.permission.QUERY_DO_NOT_ASK_CREDENTIALS_ON_BOOT	android	2
android.permission.START_VIEW_APP_FEATURES	android	258
android.permission.OVERRIDE_DISPLAY_MODE_REQUESTS	android	2
com.google.android.googleapps.permission.GOOGLE_AUTH.dodgeball	com.google.android.gsf	2
android.permission.ADD_ALWAYS_UNLOCKED_DISPLAY	android	67108866
android.permission.MANAGE_ROLLBACKS	android	18
com.google.android.launcher.permission.RECEIVE_FIRST_LOAD_BROADCAST	com.google.android.googlequicksearchbox	18
com.google.android.gms.permission.BIND_PAYMENTS_CALLBACK_SERVICE	com.google.android.gms	2
com.android.permissioncontroller.permission.MANAGE_ROLES_FROM_CONTROLLER	com.google.android.permissioncontroller	2
android.permission.UPDATE_LOCK	android	18
com.android.packageinstaller.DYNAMIC_RECEIVER_NOT_EXPORTED_PERMISSION	com.google.android.packageinstaller	2
com.google.android.finsky.permission.DSE	com.android.vending	
android.permission.ACCESS_LOWPAN_STATE	android	18
android.permission.READ_NETWORK_USAGE_HISTORY	android	18
android.permission.ACCESS_DRM_CERTIFICATES	android	18
android.permission.READ_MEDIA_AUDIO	android	1
com.google.android.gsf.permission.C2D_MESSAGE	com.google.android.gsf	2
com.google.android.apps.docs.permission.READ_MY_DATA	com.google.android.apps.docs	2
android.permission.DISABLE_HIDDEN_API_CHECKS	android	2
android.permission.INSTALL_SELF_UPDATES	android	18
android.permission.READ_MEDIA_VIDEO	android	1
com.android.vending.appdiscoveryservice.permission.ACCESS_APP_DISCOVERY_SERVICE	com.android.vending	
android.permission.SET_AND_VERIFY_LOCKSCREEN_CREDENTIALS	android	2
com.google.android.googlequicksearchbox.permission.FLUSH_LOGS	com.google.android.googlequicksearchbox	2
android.permission.BIND_SOUND_TRIGGER_DETECTION_SERVICE	android	2
android.permission.TV_VIRTUAL_REMOTE_CONTROLLER	android	18
android.permission.MANAGE_APP_OPS_RESTRICTIONS	android	258
android.permission.READ_INPUT_STATE	android	2
android.permission.MANAGE_LOWPAN_INTERFACES	android	18
android.permission.KILL_BACKGROUND_PROCESSES	android	
android.permission.BIND_ATTESTATION_VERIFICATION_SERVICE	android	2
android.permission.MANAGE_USER_OEM_UNLOCK_STATE	android	18
com.google.android.setupwizard.READ_DEVICE_ORIGIN_FIRST_PARTY	com.google.android.setupwizard	
android.permission.CACHE_CONTENT	android	67108866
com.android.phone.permission.ACCESS_LAST_KNOWN_CELL_ID	com.android.phone	2
android.permission.USE_FINGERPRINT	android	
android.permission.UPDATE_DEVICE_MANAGEMENT_RESOURCES	android	67108866
android.permission.REQUEST_NETWORK_SCORES	android	2050
android.permission.ACCESS_VOICE_INTERACTION_SERVICE	android	2
android.permission.MAINLINE_NETWORK_STACK	com.google.android.networkstack	2
android.permission.SHOW_KEYGUARD_MESSAGE	android	18
com.google.android.gms.locationsharingreporter.periodic.STATUS_UPDATE	com.google.android.gms	2
android.permission.MANAGE_MUSIC_RECOGNITION	android	67108882
android.permission.BIND_PRINT_SPOOLER_SERVICE	android	2
android.permission.BIND_DIRECTORY_SEARCH	android	18
android.permission.SECURE_ELEMENT_PRIVILEGED_OPERATION	android	18
com.android.nfc.DYNAMIC_RECEIVER_NOT_EXPORTED_PERMISSION	com.android.nfc	2
android.permission.MANAGE_SENSOR_PRIVACY	android	67109124
android.permission.CONNECTIVITY_USE_RESTRICTED_NETWORKS	android	18
android.permission.USE_SIP	android	1
android.permission.CHANGE_HDMI_CEC_ACTIVE_SOURCE	android	18
android.permission.SCHEDULE_PRIORITIZED_ALARM	android	18
android.permission.CAPTURE_TUNER_AUDIO_INPUT	android	18
android.permission.CREATE_VIRTUAL_DEVICE	android	67108868
android.permission.OVERRIDE_COMPAT_CHANGE_CONFIG	android	18
com.android.permissioncontroller.DYNAMIC_RECEIVER_NOT_EXPORTED_PERMISSION	com.google.android.permissioncontroller	2
android.permission.REQUEST_COMPANION_PROFILE_COMPUTER	android	18
android.permission.READ_BASIC_PHONE_STATE	android	
com.google.android.gms.permission.GRANT_WALLPAPER_PERMISSIONS	com.google.android.gms	2
android.permission.SOUNDTRIGGER_DELEGATE_IDENTITY	android	18
android.permission.WRITE_USER_DICTIONARY	android	
com.google.android.settings.intelligence.modules.routines.READ_ROUTINES	com.google.android.settings.intelligence	18
android.permission.REGISTER_STATS_PULL_ATOM	android	18
com.verizon.vzwavs.mvs.permission.WRITE	com.verizon.mips.services	2
android.permission.REGISTER_SIM_SUBSCRIPTION	android	18
android.permission.READ_DREAM_SUPPRESSION	android	2
android.permission.ACCESS_BROADCAST_RESPONSE_STATS	android	50
android.permission.READ_SYNC_STATS	android	
android.permission.MANAGE_OWN_CALLS	android	
com.android.captiveportallogin.DYNAMIC_RECEIVER_NOT_EXPORTED_PERMISSION	com.google.android.captiveportallogin	2
android.permission.WRITE_DREAM_STATE	android	18
android.permission.FREEZE_SCREEN	android	2
android.permission.ACCESS_VR_STATE	android	1026
android.permission.NOTIFY_TV_INPUTS	android	18
android.permission.DOWNLOAD_CACHE_NON_PURGEABLE	com.android.providers.downloads	18
android.permission.MANAGE_VIRTUAL_MACHINE	com.google.android.virtualmachine.res	34
com.google.android.apps.maps.permission.TIMELINE_POST_VISIT_BADGE	com.google.android.apps.maps	2
android.permission.ACCESS_SHORTCUTS	android	100663298
android.permission.BIND_TELEPHONY_NETWORK_SERVICE	android	2
android.permission.REBOOT	android	18
com.google.android.finsky.permission.DEVELOPER_GROUP_ID_INFO	com.android.vending	2
android.permission.DISPATCH_NFC_MESSAGE	android	18
com.google.android.apps.play.movies.common.permission.INVALIDATE_AUTH_TOKENS	com.google.android.videos	2
com.google.android.gms.chimera.permission.CONFIG_CHANGE	com.google.android.gms	2
com.google.android.googleapps.permission.GOOGLE_AUTH.health	com.google.android.gsf	2
com.google.android.gms.auth.permission.FACE_UNLOCK	com.google.android.gms	2
android.permission.MOUNT_FORMAT_FILESYSTEMS	android	18
android.permission.ACCESS_TV_TUNER	android	32786
android.permission.PROCESS_OUTGOING_CALLS	android	1
android.permission.USE_ATTESTATION_VERIFICATION_SERVICE	android	2
android.permission.READ_PEOPLE_DATA	android	100663298
android.permission.READ_CELL_BROADCASTS	android	1
androidx.fragment.DYNAMIC_RECEIVER_NOT_EXPORTED_PERMISSION	com.google.android.gsf	2
android.permission.SCHEDULE_EXACT_ALARM	android	64
android.permission.REQUEST_DELETE_PACKAGES	android	
android.permission.SUSPEND_APPS	android	67108866
android.permission.OEM_UNLOCK_STATE	android	2
com.google.android.documentsui.DYNAMIC_RECEIVER_NOT_EXPORTED_PERMISSION	com.google.android.documentsui	2
android.permission.REGISTER_CONNECTION_MANAGER	android	18
android.permission.MANAGE_DEVICE_ADMINS	android	67108866
android.permission.CLEAR_APP_CACHE	android	18
android.permission.ASSOCIATE_INPUT_DEVICE_TO_DISPLAY	android	2
android.permission.ACCESS_TV_DESCRAMBLER	android	32786
android.permission.SOUND_TRIGGER_RUN_IN_BATTERY_SAVER	android	18
android.permission.BIND_CONTROLS	android	2
com.google.android.gms.permission.CAR_VENDOR_EXTENSION	com.google.android.gms	1
com.google.android.apps.safetyhub.carcrash.settings.READ	com.google.android.apps.safetyhub	
com.google.android.gms.supervision.permission.C2D_MESSAGE	com.google.android.gms.supervision	2
android.permission.MODIFY_QUIET_MODE	android	67108914
android.permission.CHANGE_APP_IDLE_STATE	android	18
com.google.android.gms.auth.permission.GOOGLE_ACCOUNT_CHANGE	com.google.android.gms	2
android.permission.BIND_SETTINGS_SUGGESTIONS_SERVICE	android	2
android.permission.BRIGHTNESS_SLIDER_USAGE	android	50
com.google.android.gms.trustagent.framework.model.DATA_ACCESS	com.google.android.gms	2
android.permission.BIND_TRUST_AGENT	android	2
com.google.android.apps.pixelmigrate.RESET_FLOW_PERMISSION	com.google.android.apps.restore	2
com.google.android.googleapps.permission.GOOGLE_AUTH.mobile	com.google.android.gsf	2
android.permission.MANAGE_DOCUMENTS	android	67108866
android.permission.TEST_BLACKLISTED_PASSWORD	android	2
android.permission.ACCESS_PDB_STATE	android	67108866
android.permission.TEST_MANAGE_ROLLBACKS	android	2
android.permission.MANAGE_NETWORK_POLICY	android	2
android.permission.BIND_REMOTEVIEWS	android	18
com.verizon.mips.services.FILE_ACCESS	com.verizon.mips.services	18
android.permission.REMOTE_DISPLAY_PROVIDER	android	18
com.google.android.apps.gcs.permission.RECEIVE_NETWORK_SCORES	com.google.android.apps.gcs	2
android.permission.BACKGROUND_CAMERA	android	67108868
android.permission.ASEC_MOUNT_UNMOUNT	android	2
com.google.android.apps.docs.permission.SYNC_STATUS	com.google.android.apps.docs	
android.permission.GRANT_RUNTIME_PERMISSIONS	android	770
android.permission.ADD_TRUSTED_DISPLAY	android	67108866
android.permission.MANAGE_NOTIFICATION_LISTENERS	android	258
android.permission.SET_POINTER_SPEED	android	2
com.google.android.wallpaper.effects.QUERY_EFFECT	com.google.android.wallpaper.effects	1026
android.permission.SUBSTITUTE_SHARE_TARGET_APP_NAME_AND_ICON	android	18
android.permission.CHANGE_BACKGROUND_DATA_SETTING	android	2
android.permission.BIND_RESUME_ON_REBOOT_SERVICE	android	2
android.permission.READ_CONTENT_RATING_SYSTEMS	android	18
com.google.android.euicc.permission.INTERNAL_BROADCAST	com.google.android.euicc	2
android.permission.MANAGE_NOTIFICATIONS	android	2
android.permission.USE_COLORIZED_NOTIFICATIONS	android	67110914
android.permission.MANAGE_GAME_MODE	android	18
com.android.systemui.permission.SELF	com.android.systemui	2
com.android.chrome.TOS_ACKED	com.android.chrome	18
android.permission.GLOBAL_SEARCH	android	18
android.permission.BLUETOOTH_ADVERTISE	android	1
com.android.vending.p2p.APP_INSTALL_API	com.android.vending	
android.permission.WIFI_SET_DEVICE_MOBILITY_STATE	android	18
com.google.android.apps.tycho.WRITE_EXPERIMENTS	com.google.android.apps.tycho	2
android.permission.NET_TUNNELING	android	67108866
com.google.android.permission.USE_GRIL	com.google.android.grilservice	18
android.permission.SEND_SHOW_SUSPENDED_APP_DETAILS	android	2
android.permission.CONNECTIVITY_INTERNAL	android	18
com.google.android.googleapps.permission.GOOGLE_AUTH.reader	com.google.android.gsf	
android.permission.FACTORY_TEST	android	2
android.permission.SET_WALLPAPER_HINTS	android	
android.permission.BIND_SELECTION_TOOLBAR_RENDER_SERVICE	android	2
android.permission.MANAGE_MEDIA_PROJECTION	android	2
android.permission.ALLOW_SLIPPERY_TOUCHES	android	100663314
android.permission.READ_SYNC_SETTINGS	android	
android.permission.QUERY_USERS	android	67108866
android.permission.CAMERA_INJECT_EXTERNAL_CAMERA	android	2
android.permission.START_ACTIVITIES_FROM_BACKGROUND	android	67158546
com.google.android.googleapps.permission.GOOGLE_AUTH.sierra	com.google.android.gsf	2
com.google.android.gms.permission.SHOW_TRANSACTION_RECEIPT	com.google.android.gms	2
com.google.android.googleapps.permission.GOOGLE_AUTH.speech	com.google.android.gsf	2
com.google.android.apps.now.CURRENT_ACCOUNT_ACCESS	com.google.android.googlequicksearchbox	2
com.google.android.partnersetup.permission.ACCESS_PROVIDER	com.google.android.partnersetup	2
com.android.browser.permission.WRITE_HISTORY_BOOKMARKS	android	
android.permission.SUGGEST_EXTERNAL_TIME	android	18
com.android.chrome.permission.C2D_MESSAGE	com.android.chrome	2
android.permission.BIND_TELEPHONY_DATA_SERVICE	android	2
com.google.android.apps.nexuslauncher.permission.WRITE_SETTINGS	com.google.android.apps.nexuslauncher	18
android.permission.GET_ACCOUNTS	android	1
android.permission.BROADCAST_PACKAGE_REMOVED	android	2
com.android.bluetooth.DYNAMIC_RECEIVER_NOT_EXPORTED_PERMISSION	com.google.android.bluetooth	2
android.permission.BIND_CELL_BROADCAST_SERVICE	android	2
android.permission.VERIFY_ATTESTATION	android	2
android.permission.READ_COMPAT_CHANGE_CONFIG	android	18
android.permission.SET_WALLPAPER_DIM_AMOUNT	android	18
com.android.systemui.permission.FLAGS	com.android.systemui	2
android.permission.DISABLE_INPUT_DEVICE	android	2
android.permission.LOADER_USAGE_STATS	android	82
com.google.android.finsky.permission.INTERNAL_BROADCAST	com.android.vending	2
android.permission.RUN_IN_BACKGROUND	android	2
android.permission.OVERRIDE_WIFI_CONFIG	android	134217746
android.permission.MANAGE_BIOMETRIC_DIALOG	android	2
android.permission.FORCE_STOP_PACKAGES	android	18
android.permission.SUGGEST_MANUAL_TIME_AND_ZONE	android	2
com.google.android.gms.permission.CAR_MILEAGE	com.google.android.gms	1
android.permission.COMPANION_APPROVE_WIFI_CONNECTIONS	android	18
androidx.legacy.coreui.DYNAMIC_RECEIVER_NOT_EXPORTED_PERMISSION	com.google.android.gsf	2
android.permission.MANAGE_CA_CERTIFICATES	android	18
android.permission.START_VIEW_PERMISSION_USAGE	android	258
android.permission.SET_MEDIA_KEY_LISTENER	android	50
android.permission.MODIFY_TOUCH_MODE_STATE	android	2
android.permission.HIDE_NON_SYSTEM_OVERLAY_WINDOWS	android	1026
android.permission.CAPTURE_VIDEO_OUTPUT	android	2
android.permission.ACCESS_NOTIFICATIONS	android	82
com.google.android.googleapps.permission.GOOGLE_AUTH.geowiki	com.google.android.gsf	
android.permission.HANDLE_CALL_INTENT	com.android.server.telecom	18
android.permission.MEDIA_RESOURCE_OVERRIDE_PID	android	2
android.permission.WRITE_EXTERNAL_STORAGE	android	1
android.permission.TRIGGER_LOST_MODE	android	67108866
android.permission.CUSTOMIZE_SYSTEM_UI	com.android.systemui	18
android.permission.VIBRATE	android	4096
android.permission.READ_CARRIER_APP_INFO	android	2
android.permission.CAPTURE_BLACKOUT_CONTENT	android	2
com.android.vending.DYNAMIC_RECEIVER_NOT_EXPORTED_PERMISSION	com.android.vending	2
android.permission.BIND_GBA_SERVICE	android	2
android.permission.REGISTER_MEDIA_RESOURCE_OBSERVER	android	18
com.android.certinstaller.INSTALL_AS_USER	com.android.certinstaller	2
com.google.android.gsf.permission.CONNECTION	com.google.android.gsf	2
android.permission.MANAGE_TOAST_RATE_LIMITING	android	2
android.permission.BIND_ACCESSIBILITY_SERVICE	android	2
android.permission.MANAGE_APP_HIBERNATION	android	258
android.permission.MODIFY_ACCESSIBILITY_DATA	android	2
com.google.android.googleapps.permission.GOOGLE_AUTH.blogger	com.google.android.gsf	2
android.server.checkin.CHECKIN.permission.C2D_MESSAGE	com.google.android.gsf	2
android.permission.START_FOREGROUND_SERVICES_FROM_BACKGROUND	android	67158546
android.permission.MANAGE_ACTIVITY_STACKS	android	2
com.android.mtp.DYNAMIC_RECEIVER_NOT_EXPORTED_PERMISSION	com.android.mtp	2
android.permission.UPDATE_TIME_ZONE_RULES	android	18
android.permission.SEND_CALL_LOG_CHANGE	com.android.providers.contacts	18
com.google.android.dreamlinerupdater.permission.WIRELESS_CHARGER	com.google.android.dreamlinerupdater	18
com.android.wifi.dialog.DYNAMIC_RECEIVER_NOT_EXPORTED_PERMISSION	com.google.android.wifi.dialog	2
com.verizon.services.eps.EPS_SWITCH_ENV	com.verizon.mips.services	2
android.permission.HANDLE_CAR_MODE_CHANGES	android	18
android.permission.HDMI_CEC	android	32786
android.permission.BIND_INPUT_METHOD	android	2
android.permission.INVOKE_CARRIER_SETUP	android	18
android.permission.WRITE_SECURITY_LOG	android	18
android.permission.CHANGE_DEVICE_IDLE_TEMP_WHITELIST	android	18
com.android.egg.DYNAMIC_RECEIVER_NOT_EXPORTED_PERMISSION	com.android.egg	2
android.permission.REMOVE_DRM_CERTIFICATES	android	18
android.permission.INTERACT_ACROSS_PROFILES	android	66
android.permission.CHANGE_LOWPAN_STATE	android	18
android.permission.READ_USER_DICTIONARY	android	
android.permission.FILTER_EVENTS	android	2
com.google.android.googlequicksearchbox.permission.NGA_SURVEY	com.google.android.googlequicksearchbox	2
com.google.android.apps.nexuslauncher.permission.QSB	com.google.android.apps.nexuslauncher	18
com.android.wallpaper.livepicker.DYNAMIC_RECEIVER_NOT_EXPORTED_PERMISSION	com.android.wallpaper.livepicker	2
android.permission.WIFI_UPDATE_USABILITY_STATS_SCORE	android	18
com.google.android.gms.permission.SAFETY_NET	com.google.android.gms	2
android.permission.WHITELIST_RESTRICTED_PERMISSIONS	android	258
com.google.android.gms.vehicle.permission.SHARED_AUTO_SENSOR_DATA	com.google.android.gms	2
com.google.android.googleapps.permission.GOOGLE_AUTH.speechpersonalization	com.google.android.gsf	2
android.permission.RECEIVE_EMERGENCY_BROADCAST	android	18
androidx.legacy.v4.DYNAMIC_RECEIVER_NOT_EXPORTED_PERMISSION	com.google.android.hardwareinfo	2
android.permission.BIND_EXTERNAL_STORAGE_SERVICE	android	2
android.permission.SET_CLIP_SOURCE	android	33554434
com.google.android.apps.tycho.permission.C2D_MESSAGE	com.google.android.apps.tycho	2
android.permission.CAPTURE_MEDIA_OUTPUT	android	67108882
com.google.android.providers.talk.permission.READ_ONLY	com.google.android.gsf	1
com.google.android.finsky.permission.GEARHEAD_SERVICE	com.android.vending	18
com.android.printservice.recommendation.DYNAMIC_RECEIVER_NOT_EXPORTED_PERMISSION	com.google.android.printservice.recommendation	2
com.android.traceur.DYNAMIC_RECEIVER_NOT_EXPORTED_PERMISSION	com.android.traceur	2
android.permission.BIND_TEXTCLASSIFIER_SERVICE	android	2
android.permission.VIEW_INSTANT_APPS	android	1026
com.gsma.services.permission.RCS	com.shannon.rcsservice	18
android.permission.CREATE_USERS	android	2
android.permission.MANAGE_SLICE_PERMISSIONS	android	2
com.google.android.gms.googlehelp.LAUNCH_SUPPORT_SCREENSHARE	com.google.android.gms	18
android.permission.READ_CLIPBOARD_IN_BACKGROUND	android	67108866
android.permission.MODIFY_NETWORK_ACCOUNTING	android	18
com.google.android.gms.DYNAMIC_RECEIVER_NOT_EXPORTED_PERMISSION	com.google.android.gms	2
android.permission.MANAGE_SCOPED_ACCESS_DIRECTORY_PERMISSIONS	android	2
android.permission.BIND_WALLPAPER_EFFECTS_GENERATION_SERVICE	android	2
com.android.cellbroadcastservice.FULL_ACCESS_CELL_BROADCAST_HISTORY	com.google.android.cellbroadcastservice	2
com.google.android.gms.common.internal.SHARED_PREFERENCES_PERMISSION	com.google.android.gms	2
android.permission.CRYPT_KEEPER	android	67108882
android.permission.CONTROL_AUTOMOTIVE_GNSS	android	18
android.permission.SEND_EMBMS_INTENTS	android	18
android.permission.ENABLE_TEST_HARNESS_MODE	android	2
android.permission.BIND_NFC_SERVICE	android	2
android.permission.CHANGE_APP_LAUNCH_TIME_ESTIMATE	android	18
com.google.android.apps.gsa.nga.permissions.EDIT_PREFERENCES	com.google.android.googlequicksearchbox	2
android.permission.REQUEST_COMPANION_PROFILE_WATCH	android	
android.permission.MANAGE_WALLPAPER_EFFECTS_GENERATION	android	18
com.google.android.apps.messaging.services.ACCESS_MESSAGING_NOTIFICATION_SERVICE	com.google.android.apps.messaging	
android.permission.START_PRINT_SERVICE_CONFIG_ACTIVITY	com.android.printspooler	2
android.permission.CONFIGURE_DISPLAY_BRIGHTNESS	android	50
android.permission.SET_UNRESTRICTED_GESTURE_EXCLUSION	android	33554450
com.android.imsserviceentitlement.DYNAMIC_RECEIVER_NOT_EXPORTED_PERMISSION	com.android.imsserviceentitlement	2
com.android.voicemail.permission.WRITE_VOICEMAIL	android	67108882
com.google.android.gms.permission.SHOW_WARM_WELCOME_TAPANDPAY_APP	com.google.android.gms	2
com.google.android.systemui.permission.WIRELESS_CHARGER_STATUS	com.android.systemui	18
android.permission.GET_DETAILED_TASKS	android	2
android.permission.CALL_AUDIO_INTERCEPTION	android	18
com.google.android.gm.email.permission.READ_ATTACHMENT	com.google.android.gm	2
android.permission.NOTIFY_PENDING_SYSTEM_UPDATE	android	18
android.permission.DISPATCH_PROVISIONING_MESSAGE	android	18
android.permission.ALLOW_ANY_CODEC_FOR_PLAYBACK	android	18
android.permission.MODIFY_APPWIDGET_BIND_PERMISSIONS	android	18
com.verizon.mips.services.sku_launch	com.verizon.mips.services	18
android.permission.ACCESS_WIFI_STATE	android	
android.permission.ACCESS_TELEPHONY_SIMINFO_DB	com.android.providers.telephony	2
android.permission.READ_APP_SPECIFIC_LOCALES	android	2
com.google.android.gms.permission.BROADCAST_TO_GOOGLEHELP	com.google.android.gms	2
android.permission.GET_RUNTIME_PERMISSIONS	android	2
com.google.android.finsky.permission.ACCESS_INSTANT_APP_NOTIFICATION_ENFORCEMENT	com.android.vending	2
android.permission.USE_BIOMETRIC	android	
android.permission.MANAGE_SMARTSPACE	android	2
android.permission.ACT_AS_PACKAGE_FOR_ACCESSIBILITY	android	2
com.google.android.deskclock.permission.RECEIVE_ALERT_BROADCASTS	com.google.android.deskclock	18
com.google.android.gms.permission.READ_VALUABLES_IMAGES	com.google.android.gms	2
com.google.android.launcher.permission.WRITE_SETTINGS	com.google.android.googlequicksearchbox	18
android.permission.FORCE_BACK	android	2
android.permission.BIND_PHONE_ACCOUNT_SUGGESTION_SERVICE	android	2
com.android.chrome.permission.READ_WRITE_BOOKMARK_FOLDERS	com.android.chrome	18
com.google.android.googleapps.permission.GOOGLE_AUTH.groups2	com.google.android.gsf	2
android.permission.MARK_DEVICE_ORGANIZATION_OWNED	android	67108866
com.google.android.launcher.permission.RECEIVE_LAUNCH_BROADCASTS	com.google.android.googlequicksearchbox	2
android.permission.UWB_RANGING	android	1
com.google.android.apps.tycho#com.google.android.ims.providers.ACCESS_DATA	com.google.android.apps.tycho	
com.google.android.gms.dck.permission.DIGITAL_KEY_READ	com.google.android.gms	
com.google.android.launcher.permission.READ_SETTINGS	com.google.android.googlequicksearchbox	18
com.android.chrome.permission.DEBUG	com.android.chrome	2
android.permission.MANAGE_APP_OPS_MODES	android	67109634
com.android.systemui.permission.PLUGIN	com.android.systemui	2
android.permission.BIND_IMS_SERVICE	android	32786
android.permission.NETWORK_CARRIER_PROVISIONING	android	18
android.permission.MODIFY_REFRESH_RATE_SWITCHING_TYPE	android	2
com.google.android.gms.permission.CAR_FUEL	com.google.android.gms	1
com.google.android.gms.auth.authzen.permission.KEY_REGISTRATION_FINISHED	com.google.android.gms	2
com.android.settings.DYNAMIC_RECEIVER_NOT_EXPORTED_PERMISSION	com.android.settings	2
com.google.android.projection.gearhead.permission.START_PROJECTED_ACTIVITY	com.google.android.projection.gearhead	2
android.permission.CAMERA_DISABLE_TRANSMIT_LED	android	18
com.google.android.gms.home.matter.BIND_MATTER_COMMISSIONING_SERVICE	com.google.android.gms	2
android.permission.REQUEST_INSTALL_PACKAGES	android	66
android.permission.ACTIVITY_RECOGNITION	android	4097
com.google.android.gms.magictether.permission.CLIENT_TETHERING_PREFERENCE_CHANGED	com.google.android.gms	2
com.google.android.setupwizard.READ_DEVICE_ORIGIN	com.google.android.setupwizard	18
android.permission.CONTROL_INCALL_EXPERIENCE	android	67108882
android.permission.MODIFY_PHONE_STATE	android	67108882
com.google.android.gm.email.permission.GET_WIDGET_UPDATE	com.google.android.gm	2
android.permission.ACCESS_VR_MANAGER	android	2
com.google.android.gm.email.permission.UPDATE_AUTH_NOTIFICATION	com.google.android.gm	2
android.permission.MANAGE_AUTO_FILL	android	2
com.google.android.googlequicksearchbox.LAUNCH_FROM_DSP_HOTWORD	com.google.android.googlequicksearchbox	18
android.permission.PACKET_KEEPALIVE_OFFLOAD	android	18
com.android.launcher.permission.INSTALL_SHORTCUT	android	
android.permission.BIND_TEXT_SERVICE	android	2
android.permission.STATUS_BAR	android	33554450
android.permission.READ_FRAME_BUFFER	android	33554434
android.permission.QUERY_ALL_PACKAGES	android	
com.zhiliaoapp.musically.push.permission.MESSAGE	com.zhiliaoapp.musically	2
android.permission.RECORD_AUDIO	android	4097
android.permission.SEND_SMS_NO_CONFIRMATION	android	18
com.google.android.gms.DRIVE	com.google.android.gms	2
com.google.android.gms.permission.AD_ID	com.google.android.gms	
android.permission.DUMP	android	50
androidx.legacy.coreutils.DYNAMIC_RECEIVER_NOT_EXPORTED_PERMISSION	com.google.android.gsf	2
com.google.android.settings.routines.ROUTINES_ACTIONS	com.android.settings	18
android.permission.MANAGE_SEARCH_UI	android	67108866
com.google.android.googleapps.permission.GOOGLE_AUTH.sierraqa	com.google.android.gsf	2
android.permission.GET_APP_GRANTED_URI_PERMISSIONS	android	2
com.android.simappdialog.DYNAMIC_RECEIVER_NOT_EXPORTED_PERMISSION	com.android.simappdialog	2
android.permission.READ_DEVICE_CONFIG	android	1026
com.google.android.gms.permission.REQUEST_SCREEN_LOCK_COMPLEXITY	com.google.android.gms	
android.permission.LOCATION_HARDWARE	android	67108882
android.permission.SUPPRESS_CLIPBOARD_ACCESS_NOTIFICATION	android	2
android.permission.BIND_EXPLICIT_HEALTH_CHECK_SERVICE	android	18
android.permission.CONFIGURE_INTERACT_ACROSS_PROFILES	android	67108866
com.google.android.googlequicksearchbox.LAUNCH_WITH_RECORDED_AUDIO	com.google.android.googlequicksearchbox	18
android.permission.UNLIMITED_TOASTS	android	2
com.google.android.gms.people.permission.contactssync.BACKUP_SYNC_STATE_UPDATE_BROADCAST	com.google.android.gms	2
com.android.managedprovisioning.DYNAMIC_RECEIVER_NOT_EXPORTED_PERMISSION	com.android.managedprovisioning	2
android.permission.NETWORK_AIRPLANE_MODE	android	2
com.android.providers.media.module.DYNAMIC_RECEIVER_NOT_EXPORTED_PERMISSION	com.google.android.providers.media.module	2
android.permission.READ_SOCIAL_STREAM	android	
android.permission.QUERY_ADMIN_POLICY	android	67108866
android.permission.MODIFY_SETTINGS_OVERRIDEABLE_BY_RESTORE	android	2050
android.permission.WAKE_LOCK	android	4096
android.permission.READ_CONTACTS	android	1
android.permission.SET_UNRESTRICTED_KEEP_CLEAR_AREAS	android	18
android.permission.MANAGE_UI_TRANSLATION	android	67108882
com.google.android.gms.auth.cryptauth.permission.KEY_CHANGE	com.google.android.gms	2
android.permission.INJECT_EVENTS	android	2
android.permission.ACCESS_DOWNLOAD_MANAGER_ADVANCED	com.android.providers.downloads	18
android.permission.MANAGE_SENSORS	android	2
android.permission.BIND_NETWORK_RECOMMENDATION_SERVICE	android	2
android.permission.BIND_CHOOSER_TARGET_SERVICE	android	2
com.google.android.gms.permission.GROWTH	com.google.android.gms	2
android.permission.FORCE_DEVICE_POLICY_MANAGER_LOGS	android	2
android.permission.ACCESS_BACKGROUND_LOCATION	android	4097
android.permission.BIND_INLINE_SUGGESTION_RENDER_SERVICE	android	2
android.permission.UPDATE_APP_OPS_STATS	android	67109138
android.permission.REQUEST_COMPANION_PROFILE_AUTOMOTIVE_PROJECTION	android	67108868
android.permission.BIND_CONTENT_CAPTURE_SERVICE	android	2
com.android.chrome.permission.SHOW_COMPLIANCE_SCREEN	com.android.chrome	18
android.permission.MANAGE_CARRIER_OEM_UNLOCK_STATE	android	18
android.permission.ACCESS_INPUT_FLINGER	android	2
android.permission.OBSERVE_GRANT_REVOKE_PERMISSIONS	android	18
android.permission.READ_OEM_UNLOCK_STATE	android	18
android.permission.ACCESS_AMBIENT_CONTEXT_EVENT	android	67108868
android.permission.BLUETOOTH_SCAN	android	1
com.android.vending.billing.ADD_CREDIT_CARD	com.android.vending	18
android.permission.SET_HARMFUL_APP_WARNINGS	android	514
android.permission.BIND_AUGMENTED_AUTOFILL_SERVICE	android	2
android.permission.OPEN_ACCESSIBILITY_DETAILS_SETTINGS	android	258
com.google.android.setupwizard.SETUP_PROGRESS_SERVICE	com.google.android.setupwizard	18
android.permission.DELIVER_COMPANION_MESSAGES	android	
android.permission.RESTORE_RUNTIME_PERMISSIONS	android	2
com.google.android.apps.docs.permission.C2D_MESSAGE	com.google.android.apps.docs	2
android.permission.SET_SCREEN_COMPATIBILITY	android	2
android.contacts.permission.MANAGE_SIM_ACCOUNTS	com.android.providers.contacts	2
com.android.vending.billing.IN_APP_NOTIFY.permission.C2D_MESSAGE	com.android.vending	2
com.google.android.gtalkservice.permission.GTALK_SERVICE	com.google.android.gsf	2
android.permission.ACCESS_MEDIA_LOCATION	android	1
android.permission.MEDIA_CONTENT_CONTROL	android	18
android.permission.DELETE_PACKAGES	android	67108882
com.google.android.gms.magictether.permission.DISABLE_SOFT_AP	com.google.android.gms	2
com.google.android.calendar.permission.READ_OOBE	com.google.android.calendar	2
android.permission.ADJUST_RUNTIME_PERMISSIONS_POLICY	android	258
com.android.voicemail.permission.ADD_VOICEMAIL	android	1
com.google.android.gms.chromesync.permission.METADATA_UPDATED	com.google.android.gms	2
